11111111
10P00001
1110E001
1C100001
11111111
