1111111111111111111111
1100000000000C00000001
100000011110000C000001
10000011C1100000000001
10000010001000000E0001
100000P000000C00000001
1111111111111111111111
