1111
1111
1PE1
1111
1CC1
1111
