111111111111
10000000CPE1
110011111111
